MenuLCD	KEYWORD1
MenuManager	KEYWORD1
MenuEntry	KEYWORD1
MenuIntHelper	KEYWORD1
addChild	KEYWORD2
addSibling	KEYWORD2
setPrevSibling KEYWORD2
addActionCallback KEYWORD2
getMenuText	KEYWORD2
setParent	KEYWORD2
getNextSibling	KEYWORD2
getPrevSibling	KEYWORD2
getChild	KEYWORD2
getParent	KEYWORD2
ExecuteCallback	KEYWORD2
isBackEntry	KEYWORD2
numIncrease	KEYWORD2
numDecrease	KEYWORD2
getInt	KEYWORD2
MenuLCDSetup	KEYWORD2
PrintMenu	KEYWORD2
PrintLineRight	KEYWORD2
PrintLine	KEYWORD2
getLines	KEYWORD2
getCharacters	KEYWORD2
ClearLCD	KEYWORD2
getLCD	KEYWORD2
WipeMenu	KEYWORD2
addMenuRoot	KEYWORD2
getMenuRoot	KEYWORD2
DrawMenu	KEYWORD2
DoMenuAction	KEYWORD2
MenuUp	KEYWORD2
MenuDown	KEYWORD2
MenuSelect	KEYWORD2
SelectRoot	KEYWORD2
MenuBack	KEYWORD2
DoIntInput	KEYWORD2
DrawInputRow	KEYWORD2